----------------------------------- N = 51 -------------------------------------
================================================================================
------------------------------ GRAM-SMITH CLÁSSICO -----------------------------
================================================================================
--------------------------------------------------------------------------------
MATRIZ MÁGICA GERADA TEM CONDICIONAMENTO 52.9807766244
--------------------------------------------------------------------------------
NORMA DA DIFERENÇA ENTRE A E QR = 1.0886580525948375e-10
--------------------------------------------------------------------------------
NORMA DA DIFERENÇA ENTRE I E Q^T*Q = 38.962661886890686
--------------------------------------------------------------------------------
TEMPO DE EXECUÇÃO = 0.0027091503143310547s
--------------------------------------------------------------------------------


================================================================================
------------------------------ GRAM-SMITH MODIFICADO ---------------------------
================================================================================
============================== MATRIZ MÁGICA ===================================
--------------------------------------------------------------------------------
MATRIZ MÁGICA GERADA TEM CONDICIONAMENTO 52.9807766244
--------------------------------------------------------------------------------
NORMA DA DIFERENÇA ENTRE A E QR = 1.4310330698208418e-11
--------------------------------------------------------------------------------
NORMA DA DIFERENÇA ENTRE I E Q^T*Q = 2.1548137009425106e-14
--------------------------------------------------------------------------------
TEMPO DE EXECUÇÃO = 0.017919063568115234s
--------------------------------------------------------------------------------


================================================================================
------------------------------ FATORACAO HOUSEHOLDER ---------------------------
================================================================================
--------------------------------------------------------------------------------
MATRIZ MÁGICA GERADA TEM CONDICIONAMENTO 52.9807766244
--------------------------------------------------------------------------------
NORMA DA DIFERENÇA ENTRE A E QR = 7.393907708319603e-11
--------------------------------------------------------------------------------
NORMA DA DIFERENÇA ENTRE I E Q^T*Q = 38.962661886890686
--------------------------------------------------------------------------------
TEMPO DE EXECUÇÃO = 0.0075948238372802734s
--------------------------------------------------------------------------------


----------------------------------- N = 101 -------------------------------------
================================================================================
------------------------------ GRAM-SMITH CLÁSSICO -----------------------------
================================================================================
--------------------------------------------------------------------------------
MATRIZ MÁGICA GERADA TEM CONDICIONAMENTO 102.9901970395
--------------------------------------------------------------------------------
NORMA DA DIFERENÇA ENTRE A E QR = 1.9002168727411117e-09
--------------------------------------------------------------------------------
NORMA DA DIFERENÇA ENTRE I E Q^T*Q = 77.07118655757971
--------------------------------------------------------------------------------
TEMPO DE EXECUÇÃO = 0.007130861282348633s
--------------------------------------------------------------------------------


================================================================================
------------------------------ GRAM-SMITH MODIFICADO ---------------------------
================================================================================
============================== MATRIZ MÁGICA ===================================
--------------------------------------------------------------------------------
MATRIZ MÁGICA GERADA TEM CONDICIONAMENTO 102.9901970395
--------------------------------------------------------------------------------
NORMA DA DIFERENÇA ENTRE A E QR = 1.6433432392659597e-10
--------------------------------------------------------------------------------
NORMA DA DIFERENÇA ENTRE I E Q^T*Q = 6.866953573619932e-14
--------------------------------------------------------------------------------
TEMPO DE EXECUÇÃO = 0.09213852882385254s
--------------------------------------------------------------------------------


================================================================================
------------------------------ FATORACAO HOUSEHOLDER ---------------------------
================================================================================
--------------------------------------------------------------------------------
MATRIZ MÁGICA GERADA TEM CONDICIONAMENTO 102.9901970395
--------------------------------------------------------------------------------
NORMA DA DIFERENÇA ENTRE A E QR = 1.0519229931560403e-09
--------------------------------------------------------------------------------
NORMA DA DIFERENÇA ENTRE I E Q^T*Q = 77.07118655757971
--------------------------------------------------------------------------------
TEMPO DE EXECUÇÃO = 0.03664565086364746s
--------------------------------------------------------------------------------


----------------------------------- N = 151 -------------------------------------
================================================================================
------------------------------ GRAM-SMITH CLÁSSICO -----------------------------
================================================================================
--------------------------------------------------------------------------------
MATRIZ MÁGICA GERADA TEM CONDICIONAMENTO 152.9934213412
--------------------------------------------------------------------------------
NORMA DA DIFERENÇA ENTRE A E QR = 1.8538583557159427e-08
--------------------------------------------------------------------------------
NORMA DA DIFERENÇA ENTRE I E Q^T*Q = 114.84557597988203
--------------------------------------------------------------------------------
TEMPO DE EXECUÇÃO = 0.03533148765563965s
--------------------------------------------------------------------------------


================================================================================
------------------------------ GRAM-SMITH MODIFICADO ---------------------------
================================================================================
============================== MATRIZ MÁGICA ===================================
--------------------------------------------------------------------------------
MATRIZ MÁGICA GERADA TEM CONDICIONAMENTO 152.9934213412
--------------------------------------------------------------------------------
NORMA DA DIFERENÇA ENTRE A E QR = 6.662759233222459e-10
--------------------------------------------------------------------------------
NORMA DA DIFERENÇA ENTRE I E Q^T*Q = 1.3313549037709825e-13
--------------------------------------------------------------------------------
TEMPO DE EXECUÇÃO = 0.1471848487854004s
--------------------------------------------------------------------------------


================================================================================
------------------------------ FATORACAO HOUSEHOLDER ---------------------------
================================================================================
--------------------------------------------------------------------------------
MATRIZ MÁGICA GERADA TEM CONDICIONAMENTO 152.9934213412
--------------------------------------------------------------------------------
NORMA DA DIFERENÇA ENTRE A E QR = 5.728722385356377e-09
--------------------------------------------------------------------------------
NORMA DA DIFERENÇA ENTRE I E Q^T*Q = 114.84557597988203
--------------------------------------------------------------------------------
TEMPO DE EXECUÇÃO = 0.1347970962524414s
--------------------------------------------------------------------------------


----------------------------------- N = 201 -------------------------------------
================================================================================
------------------------------ GRAM-SMITH CLÁSSICO -----------------------------
================================================================================
--------------------------------------------------------------------------------
MATRIZ MÁGICA GERADA TEM CONDICIONAMENTO 202.9950496275
--------------------------------------------------------------------------------
NORMA DA DIFERENÇA ENTRE A E QR = 4.116799345865729e-08
--------------------------------------------------------------------------------
NORMA DA DIFERENÇA ENTRE I E Q^T*Q = 152.50166881538945
--------------------------------------------------------------------------------
TEMPO DE EXECUÇÃO = 0.023845195770263672s
--------------------------------------------------------------------------------


================================================================================
------------------------------ GRAM-SMITH MODIFICADO ---------------------------
================================================================================
============================== MATRIZ MÁGICA ===================================
--------------------------------------------------------------------------------
MATRIZ MÁGICA GERADA TEM CONDICIONAMENTO 202.9950496275
--------------------------------------------------------------------------------
NORMA DA DIFERENÇA ENTRE A E QR = 1.782439085218357e-09
--------------------------------------------------------------------------------
NORMA DA DIFERENÇA ENTRE I E Q^T*Q = 2.1074546517798122e-13
--------------------------------------------------------------------------------
TEMPO DE EXECUÇÃO = 0.23706579208374023s
--------------------------------------------------------------------------------


================================================================================
------------------------------ FATORACAO HOUSEHOLDER ---------------------------
================================================================================
--------------------------------------------------------------------------------
MATRIZ MÁGICA GERADA TEM CONDICIONAMENTO 202.9950496275
--------------------------------------------------------------------------------
NORMA DA DIFERENÇA ENTRE A E QR = 2.6731242996902438e-08
--------------------------------------------------------------------------------
NORMA DA DIFERENÇA ENTRE I E Q^T*Q = 152.50166881538945
--------------------------------------------------------------------------------
TEMPO DE EXECUÇÃO = 0.34366774559020996s
--------------------------------------------------------------------------------


----------------------------------- N = 251 -------------------------------------
================================================================================
------------------------------ GRAM-SMITH CLÁSSICO -----------------------------
================================================================================
--------------------------------------------------------------------------------
MATRIZ MÁGICA GERADA TEM CONDICIONAMENTO 252.996031809
--------------------------------------------------------------------------------
NORMA DA DIFERENÇA ENTRE A E QR = 1.0662492400115298e-07
--------------------------------------------------------------------------------
NORMA DA DIFERENÇA ENTRE I E Q^T*Q = 190.10205472269462
--------------------------------------------------------------------------------
TEMPO DE EXECUÇÃO = 0.03290724754333496s
--------------------------------------------------------------------------------


================================================================================
------------------------------ GRAM-SMITH MODIFICADO ---------------------------
================================================================================
============================== MATRIZ MÁGICA ===================================
--------------------------------------------------------------------------------
MATRIZ MÁGICA GERADA TEM CONDICIONAMENTO 252.996031809
--------------------------------------------------------------------------------
NORMA DA DIFERENÇA ENTRE A E QR = 4.1159751162922475e-09
--------------------------------------------------------------------------------
NORMA DA DIFERENÇA ENTRE I E Q^T*Q = 3.4867692466898935e-13
--------------------------------------------------------------------------------
TEMPO DE EXECUÇÃO = 0.3444521427154541s
--------------------------------------------------------------------------------


================================================================================
------------------------------ FATORACAO HOUSEHOLDER ---------------------------
================================================================================
--------------------------------------------------------------------------------
MATRIZ MÁGICA GERADA TEM CONDICIONAMENTO 252.996031809
--------------------------------------------------------------------------------
NORMA DA DIFERENÇA ENTRE A E QR = 5.245166789791256e-08
--------------------------------------------------------------------------------
NORMA DA DIFERENÇA ENTRE I E Q^T*Q = 190.10205472269462
--------------------------------------------------------------------------------
TEMPO DE EXECUÇÃO = 0.7393085956573486s
--------------------------------------------------------------------------------


----------------------------------- N = 301 -------------------------------------
================================================================================
------------------------------ GRAM-SMITH CLÁSSICO -----------------------------
================================================================================
--------------------------------------------------------------------------------
MATRIZ MÁGICA GERADA TEM CONDICIONAMENTO 302.9966887783
--------------------------------------------------------------------------------
NORMA DA DIFERENÇA ENTRE A E QR = 4.61921445094049e-07
--------------------------------------------------------------------------------
NORMA DA DIFERENÇA ENTRE I E Q^T*Q = 227.6718787431035
--------------------------------------------------------------------------------
TEMPO DE EXECUÇÃO = 0.047324180603027344s
--------------------------------------------------------------------------------


================================================================================
------------------------------ GRAM-SMITH MODIFICADO ---------------------------
================================================================================
============================== MATRIZ MÁGICA ===================================
--------------------------------------------------------------------------------
MATRIZ MÁGICA GERADA TEM CONDICIONAMENTO 302.9966887783
--------------------------------------------------------------------------------
NORMA DA DIFERENÇA ENTRE A E QR = 6.416144060494844e-09
--------------------------------------------------------------------------------
NORMA DA DIFERENÇA ENTRE I E Q^T*Q = 5.975852950500238e-13
--------------------------------------------------------------------------------
TEMPO DE EXECUÇÃO = 0.5285887718200684s
--------------------------------------------------------------------------------


================================================================================
------------------------------ FATORACAO HOUSEHOLDER ---------------------------
================================================================================
--------------------------------------------------------------------------------
MATRIZ MÁGICA GERADA TEM CONDICIONAMENTO 302.9966887783
--------------------------------------------------------------------------------
NORMA DA DIFERENÇA ENTRE A E QR = 1.1299789548502304e-07
--------------------------------------------------------------------------------
NORMA DA DIFERENÇA ENTRE I E Q^T*Q = 227.6718787431035
--------------------------------------------------------------------------------
TEMPO DE EXECUÇÃO = 2.1310365200042725s
--------------------------------------------------------------------------------